The Rust Standard Library = Rust標準ライブラリ
library = ライブラリ
library-defined = ライブラリ定義
multithreading = マルチスレッド処理
crate = クレイト
documentaton = ドキュメント
core type = コア型
language primitive = 言語プリミティブ
primitive type = プリミティブ型
prelude = プレリュード
macro = マクロ
standard macro = 標準マクロ
portable = 移植性のある
root = ルート
path = パス
absolute path = 絶対パス
statement = 文
expression = 式
search bar = 検索バー
module = モジュール
item = アイテム
import = インポート
container = コンテナ
collection = コレクション
contribution = 貢献
iterator = イテレータ
vector = ベクタ
array = 配列
slice = スライス
heap-allocated = ヒープに確保される
contiguous storage = 連続領域
shared reference = 共有参照
mutable = ミュータブル
immutable = イミュータブル
build = 組み立てる
mutate = 書き換える
owned = 所有されている
box = ボックス
map = マップ
set = 集合
linked list = 連結リスト
shared memory = 共有メモリ
channel = チャネル
message passing = メッセージパッシング
I/O = I/O
slice = スライスする
coercion = 型強制
coerce = 型強制
coerce = 型強制する
block of memory = メモリブロック
empty = 空
the *** (レシーバ) = この*** (例: the slice = このスライス)
element = 要素
out of bounds = 境界外
index = インデックス
subslice = 部分スライス
range = 範囲
bounds checking = 範囲チェック
buffer = バッファ
raw pointer = 生ポインタ
caller = 呼び出し元
outlive = 長生きする
allocate = 割り当て
reallocate = 再割り当て
unsafe = unsafeな
panic = パニック
panic = パニックになる
in place = インプレースで
window = ウィンドウ (sliceの連続領域)
